"Offense","Black","White","Hispanic","Other","Total"
"Aggravated Assault","2","1","0","0","3"
"Burglary","2","2","0","0","4"
"Drug Intent","1","4","0","0","5"
"Homicide/Manslaughter","3","2","0","0","5"
"Other Property","12","29","0","0","41"
"Possession Of Drugs","6","15","0","0","21"
"Robbery","0","1","0","0","1"
"Sale Of Drugs","5","10","0","0","15"
"Sex Offense","0","0","0","0","0"
"Violent","1","2","0","0","3"
"Total","32","66","0","0","98"
